-------------
minMoves: 250
zoom: 0.48
-------------
XXXXXXXXXXXXXXXXXXXXXX
XXXXX   XXXXXXXXXXXXXX
XXXXX*  XXXXXXXXXXXXXX
XXXXX  *XXXXXXXXXXXXXX
XXX  *  * XXXXXXXXXXXX
XXX X XXX X.    XXXXXX
X   X XXX XX* XXX.  .X
X *  *           .  .X
XXXXX XXXX X@XXXX.  .X
XXXXX      XXXXXXXXXXX
XXXXXXXXXXXXXXXXXXXXXX
